00 00 00 00 00 00 00 00 00 00
00 00 00 00 00 00 00 00 00 00
00 00 00 00 00 00 00 00 00 00
00 00 00 00 00 00 00 00 00 00
88 19 40 00 00 00 00 00
1b dd 2a 23 00 00 00 00
8f 19 40 00 00 00 00 00
24 18 40 00 00 00 00 00
 